52 52 52 52 52 52 52 52 52 52 52 52 52 51 50 50 50 50 50 50 50 50 50 50 50 50 50 51 52 52 52 52 52 52 52 52 52 52 52 52 52 52 52 52 52
52 52 52 52 52 52 52 52 52 52 52 52 52 51 42 42 42 42 42 42 42 42 42 42 42 42 42 51 52 52 52 52 52 52 52 52 52 52 52 52 52 52 52 52 52
52 52 52 52 52 52 52 52 52 52 52 52 52 51 42 42 42 42 42 42 42 42 42 42 42 42 42 51 52 52 52 52 52 52 52 52 52 52 52 52 52 52 52 52 52
51 50 50 50 50 51 50 50 50 50 50 50 50 51 42 42 42 42 42 51 50 50 51 42 42 42 42 51 52 52 52 52 52 52 52 52 52 52 52 52 52 52 52 52 52
51 42 42 42 42 51 42 42 42 42 42 42 42 51 42 42 42 42 42 51 42 42 51 42 42 42 42 51 52 52 52 52 52 52 52 52 52 52 52 52 52 52 52 52 52
51 42 42 42 42 51 42 42 42 42 42 42 42 42 42 42 42 42 42 51 42 42 51 42 42 42 42 51 52 52 52 52 52 52 52 52 52 52 52 52 52 52 52 52 52
51 42 42 42 42 51 42 42 42 51 42 42 42 42 42 42 42 42 42 50 50 50 51 42 42 42 42 51 52 52 52 52 52 52 52 52 52 52 52 52 52 52 52 52 52
51 42 42 42 42 51 42 42 42 51 42 42 42 42 42 42 42 42 42 42 42 42 51 42 42 42 42 51 52 52 52 52 52 52 52 52 52 52 52 52 52 52 52 52 52
51 42 42 42 42 42 42 42 42 51 42 42 42 51 42 42 42 42 42 42 42 42 51 42 42 42 42 51 52 52 52 52 52 52 52 52 52 52 52 52 52 52 52 52 52
50 50 50 50 50 50 50 50 50 50 50 50 50 51 42 42 42 42 42 42 42 42 51 42 42 42 42 51 52 52 52 52 52 52 52 52 52 52 52 52 52 52 52 52 52
52 52 52 52 52 52 52 52 52 52 52 52 52 51 42 42 42 42 42 42 42 42 51 42 42 42 42 51 52 52 52 52 52 52 52 52 52 52 52 52 52 52 52 52 52
52 52 52 52 52 52 52 52 52 52 52 52 52 51 42 42 42 42 42 42 42 42 51 42 42 42 42 51 52 52 52 52 52 52 52 52 52 52 52 52 52 52 52 52 52
52 52 52 52 52 52 52 52 52 52 52 52 52 50 50 50 50 50 50 50 50 50 50 50 50 50 50 50 52 52 52 52 52 52 52 52 52 52 52 52 52 52 52 52 52
52 52 52 52 52 52 52 52 52 52 52 52 52 52 52 52 52 52 52 52 52 52 52 52 52 52 52 52 52 52 52 52 52 52 52 52 52 52 52 42 42 42 42 42 42
52 52 52 52 52 52 52 52 52 52 52 52 52 52 52 52 52 52 52 52 52 52 52 52 52 52 52 52 52 52 52 52 52 52 52 52 52 52 52 42 42 42 42 42 42
52 52 52 52 52 52 52 52 52 52 52 52 52 52 52 52 52 52 52 52 52 52 52 52 52 52 52 52 52 52 52 52 52 52 52 52 52 52 52 42 42 42 42 42 42
52 52 52 52 52 52 52 52 52 52 52 52 52 52 52 52 52 52 52 52 52 52 52 52 52 52 52 52 52 52 52 52 52 52 52 52 52 52 52 52 52 42 42 42 42
52 52 52 52 52 52 52 52 52 52 52 52 52 52 52 52 52 52 52 52 52 52 52 52 52 52 52 52 52 52 52 52 52 52 52 52 52 52 52 52 52 42 42 42 42
52 52 52 52 52 52 52 52 52 52 52 52 52 52 52 52 52 52 52 52 52 52 52 52 52 52 52 52 52 52 52 52 52 52 52 52 52 52 52 52 52 42 42 42 42
52 52 52 52 52 52 52 52 52 52 52 52 52 52 52 52 52 52 52 52 52 52 52 52 52 52 52 52 52 52 52 52 52 52 52 52 52 52 52 52 52 42 42 42 42
