52 52 52 52 52 52 52 52 52 52 52 52 52 51 15 53 50 50 50 50 15 50 50 50 50 53 15 51 52 52 52 52 52 52 52 52 52 52 52 52 52 52 52 52 52
52 52 52 52 52 52 52 52 52 52 52 52 52 51 42 42 42 42 42 42 42 42 42 42 42 42 42 51 52 52 52 52 52 52 52 52 52 52 52 52 52 52 52 52 52
52 52 52 52 52 52 52 52 52 52 52 52 52 51 42 42 42 42 42 42 42 42 42 42 42 42 42 51 52 52 52 52 52 52 52 52 52 52 52 52 52 52 52 52 52
51 15 50 50 15 51 50 50 50 15 50 50 50 51 42 42 42 42 42 51 50 50 51 42 42 42 42 51 52 52 52 52 52 52 52 52 52 52 52 52 52 52 52 52 52
51 42 42 42 42 51 42 42 42 42 42 42 42 51 42 42 42 42 42 51 42 42 51 42 42 42 42 51 52 52 52 52 52 52 52 52 52 52 52 52 52 52 52 52 52
51 42 42 42 42 51 42 42 42 42 42 42 42 42 42 42 42 42 42 51 42 42 51 42 42 42 42 51 52 52 52 52 52 52 52 52 52 52 52 52 52 52 52 52 52
51 42 42 42 42 51 42 42 42 51 42 42 42 42 42 42 42 42 42 53 50 50 53 42 42 42 42 51 52 52 52 52 52 52 52 52 52 52 52 52 52 52 52 52 52
51 42 42 42 42 51 42 42 42 51 42 42 42 42 42 42 42 42 42 42 42 42 51 42 42 42 42 51 52 52 52 52 52 52 52 52 52 52 52 52 52 52 52 52 52
51 42 42 42 42 42 42 42 42 51 42 42 42 51 42 42 42 42 42 42 42 42 51 42 42 42 42 51 52 52 52 52 52 52 52 52 52 52 52 52 52 52 52 52 52
50 50 50 53 50 50 50 50 50 50 50 50 50 51 42 42 42 42 42 42 42 42 51 42 42 42 42 51 52 52 52 52 52 52 52 52 52 52 52 52 52 52 52 52 52
52 52 52 52 52 52 52 52 52 52 52 52 52 51 42 42 42 42 42 42 42 42 51 42 42 42 42 51 52 52 52 52 52 52 52 52 52 52 52 52 52 52 52 52 52
52 52 52 52 52 52 52 52 52 52 52 52 52 51 42 42 42 42 42 42 42 42 51 42 42 42 42 51 52 52 52 52 52 52 52 52 52 52 52 52 52 52 52 52 52
52 52 52 52 52 52 52 52 52 52 52 52 52 50 50 53 50 50 53 50 15 50 50 50 50 50 15 50 52 52 52 52 52 52 52 52 52 52 52 52 52 52 52 52 52
52 52 52 52 52 52 52 52 52 52 52 52 52 52 52 52 52 52 52 52 52 52 52 52 52 52 52 52 52 52 52 52 52 52 52 52 52 52 52 42 42 42 42 42 42
52 52 52 52 52 52 52 52 52 52 52 52 52 52 52 52 52 52 52 52 52 52 52 52 52 52 52 52 52 52 52 52 52 52 52 52 52 52 52 42 42 42 42 42 42
52 52 52 52 52 52 52 52 52 52 52 52 52 52 52 52 52 52 52 52 52 52 52 52 52 52 52 52 52 52 52 52 52 52 52 52 52 52 52 42 42 42 42 42 42
52 52 52 52 52 52 52 52 52 52 52 52 52 52 52 52 52 52 52 52 52 52 52 52 52 52 52 52 52 52 52 52 52 52 52 52 52 52 52 52 52 42 42 42 42
52 52 52 52 52 52 52 52 52 52 52 52 52 52 52 52 52 52 52 52 52 52 52 52 52 52 52 52 52 52 52 52 52 52 52 52 52 52 52 52 52 42 42 42 42
52 52 52 52 52 52 52 52 52 52 52 52 52 52 52 52 52 52 52 52 52 52 52 52 52 52 52 52 52 52 52 52 52 52 52 52 52 52 52 52 52 42 42 42 42
52 52 52 52 52 52 52 52 52 52 52 52 52 52 52 52 52 52 52 52 52 52 52 52 52 52 52 52 52 52 52 52 52 52 52 52 52 52 52 52 52 42 42 42 42
