23 23 23 23 23 23 23 23 23 23 23 23 23 23 23 23 23 23 23 23 23 23 23 23 23 23 23 23 23 23 23 23 23 23 23 23 23 23 4 4 4 4 4 4 4
23 23 23 23 23 23 23 23 23 23 23 23 23 23 23 23 23 23 23 23 23 23 23 23 23 23 23 23 23 23 23 23 23 23 23 23 23 23 4 4 4 4 4 4 4
23 23 23 23 23 23 24 24 24 23 24 24 24 23 24 24 24 23 24 24 24 23 24 24 24 23 24 24 24 23 24 24 24 23 24 24 24 23 4 4 4 4 4 4 4
23 23 23 23 23 23 23 23 23 23 23 23 23 23 23 23 23 23 23 23 23 23 23 23 23 23 23 23 23 23 23 23 23 23 23 23 23 23 4 4 4 4 4 4 4
23 23 23 23 23 23 23 23 23 23 23 23 23 23 23 23 23 23 23 23 23 23 23 23 23 23 23 23 23 23 23 23 23 23 23 23 23 23 4 4 4 4 4 4 4
23 23 23 23 23 23 24 23 7 7 7 7 7 7 7 7 7 7 7 7 7 7 7 7 7 7 7 7 23 23 24 23 23 23 23 7 7 7 7 7 7 7 7 7 7
23 23 23 23 23 23 24 23 7 11 9 9 15 6 15 9 22 9 9 9 5 1 2 5 1 2 5 7 23 23 23 23 23 23 5 5 5 5 4 4 4 4 4 4 4
23 23 23 23 23 23 23 23 7 11 5 5 5 5 5 5 5 5 5 5 5 3 4 5 3 4 5 7 23 23 24 23 23 23 5 5 5 5 4 4 4 4 4 4 4
23 23 23 23 23 23 24 23 7 11 5 5 5 5 5 5 5 5 5 11 1 2 5 5 5 1 2 7 23 23 24 23 23 23 5 5 5 5 4 4 4 4 4 4 4
23 23 23 23 23 23 24 23 7 11 9 9 6 9 9 9 9 5 5 21 3 4 5 5 5 3 4 7 23 23 23 23 23 23 5 5 5 5 4 4 4 4 4 4 4
23 23 23 23 23 23 23 23 7 11 5 5 5 5 5 5 5 5 5 21 5 1 2 5 1 2 5 7 23 23 24 23 23 23 5 5 5 5 4 4 4 4 4 4 4
23 23 23 23 23 23 24 23 7 11 5 5 5 5 5 5 5 5 5 11 5 3 4 5 3 4 5 7 23 23 24 23 23 23 5 5 5 5 4 4 4 4 4 4 4
23 23 23 23 23 23 24 23 7 11 5 5 5 5 5 5 5 5 5 11 1 2 5 5 5 1 2 7 23 23 23 23 23 23 5 5 5 5 4 4 4 4 4 4 4
23 23 23 23 23 23 23 23 7 9 9 6 9 6 9 9 16 9 9 9 3 4 5 5 5 3 4 7 23 23 24 23 23 23 5 5 5 5 4 4 4 4 4 4 4
23 23 23 23 23 23 24 23 7 7 7 7 7 7 7 7 7 7 7 7 7 7 7 7 7 7 7 7 23 23 24 23 23 23 7 7 7 5 5 4 4 4 4 4 4
23 23 23 23 23 23 24 23 23 23 23 23 23 23 23 23 23 23 23 23 23 23 23 23 23 23 23 23 23 23 23 23 23 23 23 23 23 23 4 4 4 4 4 4 4
23 23 23 23 23 23 23 23 23 23 23 23 23 23 23 23 23 23 23 23 23 23 23 23 23 23 23 23 23 23 23 23 23 23 23 23 23 23 4 4 4 4 4 4 4
23 23 23 23 23 23 24 24 24 23 24 24 24 23 24 24 24 23 24 24 24 23 24 24 24 23 24 24 24 23 24 24 24 23 24 24 24 23 4 4 4 4 4 4 4
23 23 23 23 23 23 23 23 23 23 23 23 23 23 23 23 23 23 23 23 23 23 23 23 23 23 23 23 23 23 23 23 23 23 23 23 23 23 4 4 4 4 4 4 4
23 23 23 23 23 23 23 23 23 23 23 23 23 23 23 23 23 23 23 23 23 23 23 23 23 23 23 23 23 23 23 23 23 23 23 23 23 23 4 4 4 4 4 4 4



